1111
1P11
1C11
1C01
1E11
1111
