1111111111
1001C00101
1000000011
1P0011E101
1111111111
