111111
1PEC01
101101
100001
111111
