1111111111111111111111
1110111111111111111111
110P011111111111111111
1110111111111111111111
111C111111111111111111
1110111111111111111111
111E111111111111111111
1111111111111111111111
1111111111111111111111
1111111111111111111111
1111111111111111111111
