111111
1P1111
101101
1C1111
1E1111
111111
