1111111111
1001C00001
1000001011
1P0011E001
1111111111
